w01 w01 w01 w01 w01 w01 w01 w01 w01 w01 w01 w01 w00 w00 w00 w00
w01 p00 v00 v00 b00 w01 v00 v00 v00 v00 v00 w01 v00 v00 v00 w00
w01 v00 v00 v00 v00 w01 v00 v00 v00 v00 v00 w01 v00 v00 v00 w00
w01 v00 v00 v00 v00 d00 v00 v00 v00 v00 e01 v00 v00 v00 v00 w00
w01 v00 v00 o07 b04 w01 v00 v00 v00 v00 v00 w01 v00 v00 v00 w00
w01 w01 w01 w01 w01 w01 w01 w01 w01 w01 w01 w01 v00 v00 v00 w00
w01 v00 v00 v00 e02 w01 v00 v00 v00 v00 v00 w00 v00 v00 v00 w00
w01 v00 v00 v00 v00 w01 v00 v00 v00 v00 v00 w00 v00 v00 v00 w00
w01 v00 v00 v00 v00 w01 v00 w00 w00 w00 v00 w00 v00 v00 v00 w00
w01 v00 v00 v00 v00 w01 v00 w00 v00 v00 v00 w00 d01 d01 d01 w00
w01 v00 v00 v00 v00 w01 v00 w00 v00 v00 v00 w00 v00 v00 v00 w00
w01 v00 v00 v00 v00 w01 v00 w00 v00 w00 w00 w00 v00 v00 v00 w00
w01 v00 v00 v00 v00 w01 v00 w00 v00 w00 v00 v00 v00 v00 v00 w00
w01 v00 w01 w01 w01 w01 v00 w00 v00 w00 v00 w00 v00 e01 v00 w00
w01 v00 v00 v00 v00 v00 e01 w00 v00 v00 v00 w00 e01 v00 e01 w00
w01 w01 w01 w01 w01 w01 w01 w00 w00 w00 w00 w00 w00 w00 w00 w00
