w03 w03 w03 w03 w03 w03 w03 w03
w03 p00 v00 v00 v00 v00 v00 w03
w03 v00 v00 v00 v00 v00 v00 w03
w03 v00 v00 v00 v00 v00 v00 w03
w03 v00 v00 v00 v00 v00 v00 w03
w03 v00 v00 v00 v00 v00 v00 w03
w03 v00 v00 v00 v00 v00 b00 w03
w03 w03 w03 w03 w03 w03 w03 w03
