w03 w03 w03 w03 w03 w03 w03 w03
w03 p00 v00 v00 i07 v00 v00 w03
w03 v00 v00 v00 v00 v00 v00 w03
w03 v00 v00 v00 i08 v00 v00 w03
w03 v00 v00 v00 v00 v00 v00 w03
w03 v00 v00 v00 i09 v00 v00 w03
w03 v00 v00 v00 v00 v00 b00 w03
w03 w03 w03 w03 w03 w03 w03 w03
