w03 w03 w03 w03 w03 w03 w03 w01 w01 w01 w01 w01 w01 w01 w01 w01
w03 v00 v00 v00 v00 v03 w03 v12 v12 v12 v12 v12 v12 v12 v12 w01
w03 p00 v00 v00 v00 v03 w03 v00 v00 v00 v00 v01 v00 v00 v12 w01
w03 v00 v00 v00 v00 v00 d08 v00 v00 v00 v04 v00 v00 v00 v12 w01
w03 v00 v00 v00 v00 v03 w03 v00 v00 v00 v00 v01 v00 v00 v12 w01
w03 w03 w03 w03 w03 w03 w01 w01 w01 w01 w01 d05 d05 w01 w01 w02
w16 w17 w16 w16 w16 w00 v00 v00 v00 v00 w02 v00 v00 v00 v00 w00
w16 v00 v00 b00 w16 w00 v00 v00 v00 v00 w02 v00 v00 v00 v00 w00
w16 e03 v00 v00 w16 w00 v00 w00 w00 v00 w02 w02 w02 w02 v00 w00
w16 v00 v00 v00 w16 w00 v00 w00 v00 v00 w07 w00 v01 v01 v01 w00
w17 v00 v00 v00 w17 w00 v00 w00 v00 v00 w06 w00 v00 v00 v00 w00
w16 v00 v00 v00 w16 w00 v00 w00 v00 w00 w00 w00 v00 v00 v00 w00
w16 v00 v00 v00 w16 w00 v00 w00 v00 w00 v00 v00 v00 v00 v00 w00
w19 v00 w19 w19 w19 w00 v00 w00 v00 w00 v00 w02 e01 v00 e01 w00
w19 v00 v00 v00 v00 v00 v00 w00 v00 v00 v00 w02 v00 e01 v00 w00
w19 w19 w19 w19 w19 w19 w19 w00 w10 w12 w11 w00 w07 w06 w06 w00
