w01 w01 w01 w01 w01 w01 w01 w01 w01 w01 w01 w01 w00 w00 w00 w00
w01 p00 v00 v00 v00 w01 v00 v00 v00 v00 v00 w01 v00 v00 v00 w00
w01 v00 v00 p00 v00 w01 v00 v00 v00 v00 v00 w01 v00 v00 v00 w00
w01 v00 v00 v00 v00 d05 v00 v00 v00 v00 e01 v00 v00 v00 v00 w00
w01 v00 v00 v07 v04 w01 v00 v00 v00 v00 v00 w01 v00 v00 v00 w00
w01 w01 w01 w01 w01 w01 w01 w01 w01 w01 w01 w01 v00 v00 v00 w00
w01 v00 v00 v00 b00 w01 v00 v00 v00 v00 v00 w00 v00 v00 v00 w00
w01 v00 v00 v00 v01 w01 v00 v00 v00 v00 v00 w00 v00 v00 v00 w00
w01 v00 v00 v00 v00 w01 v00 w00 w00 w00 v00 w00 v00 v00 v00 w00
w01 e02 v00 v00 v00 w01 v00 w00 v00 v00 v00 w00 d02 d02 d02 w00
w01 v00 v00 v00 v00 w01 v00 w00 v00 v00 v00 w00 v00 v00 v00 w00
w01 v00 v00 v00 v00 w01 v00 w00 v00 w00 w00 w00 v00 v00 v00 w00
w01 v00 v00 v00 v00 w01 v00 w00 v00 w00 v00 v00 v00 v00 v00 w00
w01 v00 w01 w01 w01 w01 v00 w00 v00 w00 v00 w00 v00 e02 v00 w00
w01 v00 v00 v00 v00 v00 v00 w00 v00 v00 v00 w00 e01 v00 e01 w00
w01 w01 w01 w01 w01 w01 w01 w00 w00 w00 w00 w00 w06 w07 w07 w00
